0
0
#######################################################
#######################################################
#######################################################
#######################################################
#######################################################
#######################################################
#######################################################
#######################################################
#######################################################
######################                                 
######################                                 
######################   ##############################
######################   ##############################
######################   ##############################
######################   ##############################
######################   ##############################
######################   ##############################
######################   ##############################
######################   ##############################
######################   ##############################
