0
1
#######################################################
#######################################################
################################[__]##  #####  ########
################################                 ######
######  ########################                 ######
#####     ######################                   ####
####      ######################                   ####
####      ####   ##############                    ####
####        ##    #############                    ####
                                                       
                                                       
######                                            #####
######                                            #####
##########################   #################    #####
##########################   ################## #######
##########################   ##########################
##########################   ##########################
##########################   ##########################
##########################   ##########################
##########################   ##########################
