0
2
#######################################################
#######################################################
#######################################################
######################################   ##############
#####################################      ############
#####################################         #########
#####################################           #######
####################################              #####
###################################               #####
                                                       
                                                       
########   #########################                   
########   #########################                   
########   #########################                   
########   #########################                   
########   ###########################                 
########   ############################                
########   ############################################
########   ############################################
########   ############################################
