0
3
#######################################################
#######################################################
####  #################################################
####     ##############################################
###        ############################################
###         ###########################################
###           #########################################
###            ########################################
##              ######[__]#############################
                                     ##################
                                     ##################
                ##################   ##################
               ###################   ##################
              ####################   ##################
             #####################   ##################
           #######################   ##################
          ########################   ##################
##################################   ##################
##################################   ##################
##################################   ##################
