#####################     #############################
#####################     #############################
####################      #############################
###################       #############################
#########                 #############################
########                  #############################
######                    #############################
#####                      ############################
#####                       ###########################
                                                       
                                                       
                                                       
#####                                         #########
#####                                         #########
#####                                         #########
#####                                         #########
#####                                         #########
#######################################################
#######################################################
#######################################################
